9 11
#########
#  ######
#P    O #
#  ###O #
#       #
#       #
##BX#####
# X    ##
#      ##
#     G##
#########
